{
    "0": "C",
    "1": "N",
    "2": "O",
    "3": "F",
    "4": "I",
    "5": "Cl",
    "6": "Br"
}